1111111111
1000000001
1011000001
1000020001
1010000001
1000000001
1000001001
1001000001
1001000001
1111111111
