111111111111111111111111111111111
133333333333333333333333333333331
130000000000000030000000000000031
130333333333333330000000000000031
130300000000000032000000000000031
130333333333333333333333300000031
130000000000000000000000300000031
130000000000000000000000300000031
130000000000000000000000300000031
130000000000000000000000300000031
133333333333033333333333300000031
130300000001010000000000000000031
130300000001010000000000300000031
130300000001010000000000300000031
130000000001010000000000300000031
133333333331011111333333300000031
130000010000000001000300000000031
130000010000000001000333333333331
133333310111111101000000000000031
130000010100300101000000000011131
130000010100300101000000000010131
130000010100300101000000000010131
130000010100300101000000000010131
131111110100311101000000000010131
130000000100300001000000000010131
133333333333333333111111111110131
130000000000000003000000000000131
133333333000000003033333333333331
130000000000000303030000000010131
130000000000000300300010000010131
130000000000000300000000000010131
130000033333333333333333333310131
133333334000000000000000000000331
111111111111111111111111111111111
