
R 700 600
B 0
NO ./textures/fl.xpm
SO ./textures/WALL_04.xpm
EA ./textures/lava.XPM
WE ./textures/escalier.xpm
S ./textures/healing.xpm
F 0	, 0	, 0
C 255,	 14	, 72

111111111111111111111111111111111
133333333333333333333333333333331
130000000000000030000000300000031
130333333333333330000000300000031
1303000000080000B0000000300000031
130333333333033333333333300000031
130300000003030000000000000000031
130300000003030000000000000000031
130333333333030000000000000000031
130000000003030000300000000000031
133333333333033333000000000000031
130300030000000003000000100000031
130300030000000003000000000000031
1303000300BBB00003000000000000031
1300000900BBB00009000000000000031
13333333000A000003000000000000031
130000030000000003000000000000031
130000030000000003330333333333331
133333330373338303030300000000331
130000030300300303030333333830331
130000030300300303030380000030331
130000030333300303030330333030331
130000030030300300330330003030331
133333338300333383030338333030331
130000030000300300030000000080331
133333333333333333338333333330331
130000000000000003000000000000331
133333333000000003333333333333331
130000000000000303030000000030331
130000000000000300300030000030331
130000000000000300000000000030331
130000033333333333333333333330331
133333330000000000000000000000331
111111111111111111111111111111111
