1111111111
1000000101
1000000411
1000000101
1000000001
1000000001
1303311011
1302312011
1333311111
1111111111
