720 720
111111111111111111111111111111111
100000000000000000000000000000001
100000000000000010000000000000001
100000000000000010000000000000001
100000000000000010000000000000001
111111111111111111111111100000001
100000000000000000000000100000001
100000000000000000000000100000001
100000000000000000000000100000001
100000000000000000000000100000001
100111111111111111111111100000001
100100000000000000000000000000001
100100000000000000000000100000001
100100000000000000000000100000001
100000000000000000000000100000001
111111111111111000111111100000001
100000000000000000000100000000001
100000000000000000000111111111111
111111111111100000000000000000001
100000000000100000000000000000001
100000000000100000000000000000001
100000000000100000000000000000001
100000000000100000000000000000001
100000000000100000000000000000001
100000000000100000000000000000001
100111111111111111111111111110001
100000000000000000000000000010001
111111111000000000000000000010001
100000000000000100000000000010001
100000000000000100000000000010001
100000000000000100000000000010001
100000011111111111111111111110001
100000000000000000000000000000001
111111111111111111111111111111111
