R 800 800

P x1 y1 x2 y2

111111111111111111111111111111111
133333333333333333333333333333331
130000000000000000000000100000031
130333333333333330000000100000031
130300000000000030000000100000031
130333333333333333333333300000031
130300000000000000000000300000031
130300000000000000000000300000031
130333333333330000000000300000031
130000000000030000000000300000031
133333333333033333333333301111131
130300010000000001000000001000131
130300010000000001000000301010131
130300010000000001000000301010031
130000010000000001000000301010031
133333330000000001333333301110031
130000010000000001000300001010031
130000010000000001111333333133331
133333310111111101000000000000131
130000010100300101000000000010131
130000010100300101000222000010131
130000010100300101000272000010131
130000010100300101000222000010131
131111110100311101000000000010131
130000000100300001000000000010131
133333333333333333111111111110131
130000000000000003000000000000131
133333333000000003033333333333331
130000000000000303030000000010131
130000000000000300300010000010131
130000000000000300000000000010131
130000033333333333333333333310131
133333334000000000000000000000331
111111111111111111111111111111111
