R 700 	600
B 1
NO ./textures/WALL_01.XPM
SO ./textures/WALL_04.XPM
EA ./textures/fl.XPM
WE ./textures/escalier.xpm
S ./textures/loli.xpm
F 0,0,0
C 0,0,0
111111111111111111111111111111111
1BBBBBBBBBBBBBBBBBBBBBBBBBBBBBBB1
1BBBBBBBBBBBBBBBBBBBBBBBBBBBBBBB1
1BBBBBBBBBBBBBBBBBBBBBBBBBBBBBBB1
1BBBBBBBBBBBBBBBBBBBBBBBBBBBBBBB1
1BBBBBBBBBBBBBBBBBBBBBBBBBBBBBBB1
1BBBBBBBBBBBBBBBBBBBBBBBBBBBBBBB1
1BBBBBBBBBBBBBBBBBBBBBBBBBBBBBBB1
1BBBBBBBBBBBBBBBBBBBBBBBBBBBBBBB1
1BBBBBBBBBBBBBBBBBBBBBBBBBBBBBBB1
1BBBBBBBBBBBBBBBBBBBBBBBBBBBBBBB1
1BBBBBBBBBBBBBBBBBBBBBBBBBBBBBBB1
1BBBBBBBBBBBBBBBBBBBBBBBBBBBBBBB1
1BBBBBBBBBBBBBBEBBBBBBBBBBBBBBBB1
1BBBBBBBBBBBBBBBBBBBBBBBBBBBBBBB1
1BBBBBBBBBBBBBBBBBBBBBBBBBBBBBBB1
1BBBBBBBBBBBBBBBBBBBBBBBBBBBBBBB1
1BBBBBBBBBBBBBBBBBBBBBBBBBBBBBBB1
1BBBBBBBBBBBBBBBBBBBBBBBBBBBBBBB1
1BBBBBBBBBBBBBBBBBBBBBBBBBBBBBBB1
1BBBBBBBBBBBBBBBBBBBBBBBBBBBBBBB1
1BBBBBBBBBBBBBBBBBBBBBBBBBBBBBBB1
1BBBBBBBBBBBBBBBBBBBBBBBBBBBBBBB1
1BBBBBBBBBBBBBBBBBBBBBBBBBBBBBBB1
1BBBBBBBBBBBBBBBBBBBBBBBBBBBBBBB1
1BBBBBBBBBBBBBBBBBBBBBBBBBBBBBBB1
111111111111111111111111111111111
