R 700 	600
NO ./textures/WALL_01.XPM
SO ./textures/WALL_04.XPM
EA ./textures/fl.XPM
WE ./textures/escalier.xpm
S ./textures/loli.xpm
F 0,0,0
C 0,0,0
111111111111111111111111111111111
122222222222222222222222222222221
122222222222222222222222222222221
122222222222222222222222222222221
122222222222222222222222222222221
122222222222222222222222222222221
122222222222222222222222222222221
122222222222222222222222222222221
122222222222222222222222222222221
122222222222222222222222222222221
122222222222222222222222222222221
122222222222222222222222222222221
122222222222222222222222222222221
122222222222222E22222222222222221
122222222222222222222222222222221
122222222222222222222222222222221
122222222222222222222222222222221
122222222222222222222222222222221
122222222222222222222222222222221
122222222222222222222222222222221
122222222222222222222222222222221
122222222222222222222222222222221
122222222222222222222222222222221
122222222222222222222222222222221
122222222222222222222222222222221
122222222222222222222222222222221
111111111111111111111111111111111
