
B 1

wabalubadubdub


   111111 111111
 11100001110000111
1100000000000000011
1000000000000002001
110000000N000000011
 11100000A00000111
   1111000001111
      1110111
        101
        111
