R 700 	600 dasdhuasiudhasud

NO ./textures/WALL_01.XPM
SO ./textures/WALL_04.XPM
EA ./textures/fl.XPM


WE ./textures/escalier.xpm
S ./textures/loli.xpm
F 156, 153, 42
C 12, 80, 255

        1111111111111111111111111
        1000000000110000000000001
        1011000001110000002000001
        1001000000000000000000001
111111111011000001110000000000001
100000000011000001110111111111111
11110111111111011100000010001
11110111111111011101010010001
11000000110101011100000010001
10002000000000001100000010001
10000000000000001101010000001
11000001110101011101011110N0111
11110111 1110101 101111000001
11111111 1111111 111111111111
