R 700 	600
B 1
NO ./textures/WALL_01.XPM
SO ./textures/WALL_04.XPM
EA ./textures/fl.XPM
WE ./textures/escalier.xpm
S ./textures/healing.xpm
F 0,0,0
C 0,0,0

111111111111111111111111111111111
1333333333333333       33333333333333331
1000000000000000000N1111111111111
111111110000000000        001
10000000000000000000111111       1111111
100000000000000000001
10000000000000000  0011
100111111111111111111
1011
101111111111           11111111111111111111
10000000000000000000000000000001
11111111111111111111111111111111
